000000000000
000000000000
000000000000
000000000000
000000000000
000000000000
010011000100
010011000100
010011000100
010011000100
010011000100
010011000100
010011000100
010011000100
010011000100
010011000100
010011000100
010011000100
010011000100
010011000100
010011000100
010011000100
100110001001
100110001001
100110001001
100110001001
100110001001
100110001001
100110001001
010011000100
010011000100
010011000100
010011000100
010011000100
010011000100
010011000100
010011000100
000000000000
000000000000
000000000000
000000000000
000000000000
000000000000
000000000000
000000000000
010011000100
010011000100
010011000100
010011000100
010011000100
010011000100
010011000100
100110001001
100110001001
100110001001
100110001001
100110001001
100110001001
100110001001
100110001001
010011000100
010011000100
010011000100
010011000100
010011000100
010011000100
010011000100
010011000100
000000000000
000000000000
000000000000
000000000000
000000000000
000000000000
000000000000
010011000100
010011000100
010011000100
010011000100
010011000100
010011000100
010011000100
010011000100
100110001001
100110001001
100110001001
100110001001
100110001001
100110001001
100110001001
100110001001
010011000100
010011000100
010011000100
010011000100
010011000100
010011000100
010011000100
010011000100
000000000000
000000000000
000000000000
000000000000
000000000000
000000000000
000000000000
010011000100
010011000100
010011000100
010011000100
010011000100
010011000100
010011000100
010011000100
100110001001
100110001001
100110001001
100110001001
100110001001
100110001001
100110001001
100110001001
010011000100
010011000100
010011000100
010011000100
010011000100
010011000100
010011000100
000000000000
000000000000
000000000000
000000000000
000000000000
000000000000
000000000000
000000000000
010011000100
010011000100
010011000100
010011000100
010011000100
010011000100
010011000100
010011000100
100110001001
100110001001
100110001001
100110001001
100110001001
100110001001
100110001001
010011000100
010011000100
010011000100
010011000100
010011000100
010011000100
010011000100
010011000100
000000000000
000000000000
000000000000
000000000000
000000000000
000000000000
000000000000
000000000000
010011000100
010011000100
010011000100
010011000100
010011000100
010011000100
010011000100
100110001001
100110001001
100110001001
100110001001
100110001001
100110001001
100110001001
100110001001
010011000100
010011000100
010011000100
010011000100
010011000100
010011000100
010011000100
010011000100
000000000000
000000000000
000000000000
000000000000
000000000000
000000000000
000000000000
000000000000
010011000100
010011000100
010011000100
010011000100
010011000100
010011000100
010011000100
100110001001
100110001001
100110001001
100110001001
100110001001
100110001001
100110001001
100110001001
000000000000
000000000000
000000000000
000000000000
000000000000
000000000000
000000000000
000000000000
010011000100
010011000100
010011000100
010011000100
010011000100
010011000100
010011000100
100110001001
100110001001
100110001001
100110001001
100110001001
100110001001
100110001001
100110001001
010011000100
010011000100
010011000100
010011000100
010011000100
010011000100
010011000100
010011000100
000000000000
000000000000
000000000000
000000000000
000000000000
000000000000
000000000000
010011000100
010011000100
010011000100
010011000100
010011000100
010011000100
010011000100
010011000100
100110001001
100110001001
100110001001
100110001001
100110001001
100110001001
100110001001
100110001001
010011000100
010011000100
010011000100
010011000100
010011000100
010011000100
010011000100
000000000000
000000000000
000000000000
000000000000
000000000000
000000000000
000000000000
000000000000
010011000100
010011000100
010011000100
010011000100
010011000100
010011000100
010011000100
010011000100
100110001001
100110001001
100110001001
100110001001
100110001001
100110001001
100110001001
100110001001
010011000100
010011000100
010011000100
010011000100
010011000100
010011000100
010011000100
000000000000
000000000000
000000000000
000000000000
000000000000
000000000000
000000000000
000000000000
010011000100
010011000100
010011000100
010011000100
010011000100
010011000100
010011000100
010011000100
100110001001
100110001001
100110001001
100110001001
100110001001
100110001001
100110001001
010011000100
010011000100
010011000100
010011000100
010011000100
010011000100
010011000100
010011000100
000000000000
000000000000
000000000000
000000000000
000000000000
000000000000
000000000000
000000000000
010011000100
010011000100
010011000100
010011000100
010011000100
010011000100
010011000100
100110001001
100110001001
100110001001
100110001001
100110001001
100110001001
100110001001
100110001001
010011000100
010011000100
010011000100
010011000100
010011000100
010011000100
010011000100
010011000100
000000000000
000000000000
000000000000
000000000000
000000000000
000000000000
000000000000
010011000100
010011000100
010011000100
010011000100
010011000100
010011000100
010011000100
010011000100
100110001001
100110001001
100110001001
100110001001
100110001001
100110001001
100110001001
100110001001
010011000100
010011000100
010011000100
010011000100
010011000100
010011000100
